{
    "gates": [{
        "x": 1152,
        "y": 32,
        "width": 32,
        "height": 32,
        "nivel_destino": "2",
        "destino_x": 0,
        "destino_y": -1
    }],
    "coins": [
        [1, 1],
        [34, 6],
        [8, 12],
        [14, 15],
        [21, 12],
        [5, 13],
        [3, 6],
        [23, 4],
        [33, 4],
        [19, 1],
        [30, 1],
        [27, 4],
        [14, 6],
        [13, 1],
        [21, 6]
    ],
    "spikes": [
        [14, 15, 1, 115, 0, 0.1],
        [19.5, 2.5, 0, 50, 0, 0.08],
        [23.5, 2.5, 0, 50, 1, 0.08],
        [27.5, 2.5, 0, 50, 0, 0.08],
        [31.5, 2.5, 0, 50, 1, 0.08],
        [26.5, 4, 1, 225, 1, 0.04],
        [26.5, 1, 1, 225, 0, 0.04],
        [14.5, 6, 1, 125, 1, 0.08]
    ],
    "platforms": [
        [31.5, 10.5, 50, 1, 0.08],
        [31.5, 13, 50, 0, 0.02]

    ],
    "blocks": [
        [15, 0, 0, 4],
        [12, 5, 5, 4],
        [13, 0, 0, 4],
        [33, 5, 5, 6],
        [16, 5, 5, 4],
        [17, 5, 5, 4]
    ],
    "tile_size": 32,
    "columnas": 36,
    "filas": 17,
    "reaparicion_x": 1,
    "reaparicion_y": 14,
    "mapa": [
        0, 0, 0, 0, 0, 0, 0, 0, 0, 0, 0, 0, 0, 0, 0, 0, 0, 0, 0, 0, 0, 0, 0, 0, 0, 0, 0, 0, 0, 0, 0, 0, 0, 0, 0, 0,
        0, 1, 1, 1, 1, 1, 1, 1, 1, 1, 1, 1, 1, 1, 1, 1, 1, 1, 1, 1, 1, 1, 1, 1, 1, 1, 1, 1, 1, 1, 1, 1, 1, 1, 1, 1,
        20, 2, 1, 1, 1, 1, 1, 1, 1, 1, 1, 1, 1, 1, 1, 1, 1, 1, 1, 1, 1, 1, 1, 1, 1, 1, 1, 1, 1, 1, 1, 1, 1, 1, 0, 0,
        20, 1, 1, 1, 1, 1, 0, 1, 1, 1, 1, 1, 1, 1, 1, 1, 1, 1, 1, 1, 1, 1, 1, 1, 1, 1, 1, 1, 1, 1, 1, 1, 1, 0, 0, 0,
        20, 1, 1, 1, 2, 1, 0, 0, 0, 0, 0, 0, 1, 1, 0, 1, 1, 1, 0, 1, 1, 1, 1, 1, 1, 1, 1, 1, 1, 1, 1, 1, 1, 1, 0, 21,
        0, 1, 1, 1, 1, 0, 0, 0, 0, 20, 0, 0, 0, 0, 0, 0, 0, 0, 0, 0, 0, 0, 0, 0, 0, 0, 0, 0, 0, 0, 0, 0, 0, 0, 0, 0,
        20, 1, 1, 1, 1, 1, 1, 1, 1, 0, 1, 1, 1, 1, 1, 1, 1, 1, 26, 0, 1, 1, 1, 4, 1, 1, 1, 1, 1, 1, 1, 1, 1, 1, 1, 0,
        0, 1, 1, 2, 1, 1, 1, 1, 1, 0, 1, 1, 1, 1, 1, 1, 1, 1, 1, 0, 1, 1, 1, 1, 1, 1, 1, 1, 1, 1, 1, 1, 1, 1, 1, 0,
        0, 1, 1, 1, 1, 1, 1, 1, 1, 1, 1, 1, 1, 1, 0, 1, 1, 1, 1, 1, 1, 2, 1, 1, 0, 1, 1, 1, 1, 1, 1, 2, 1, 1, 2, 0,
        19, 3, 3, 3, 3, 3, 0, 1, 1, 1, 1, 1, 1, 1, 0, 1, 1, 1, 1, 0, 3, 3, 3, 3, 0, 1, 1, 1, 1, 1, 1, 1, 1, 1, 1, 0,
        0, 0, 0, 0, 0, 0, 21, 0, 0, 0, 0, 0, 0, 0, 21, 0, 0, 0, 0, 0, 0, 0, 0, 0, 21, 0, 0, 0, 0, 1, 1, 1, 1, 1, 1, 0,
        0, 0, 0, 0, 0, 20, 21, 21, 0, 0, 0, 0, 20, 20, 20, 21, 0, 0, 0, 0, 0, 0, 20, 21, 20, 0, 0, 0, 0, 1, 1, 1, 1, 1, 1, 0,
        0, 4, 4, 4, 4, 0, 20, 0, 1, 1, 1, 26, 0, 20, 20, 20, 1, 1, 1, 1, 1, 1, 0, 0, 0, 4, 4, 4, 4, 1, 1, 1, 1, 2, 1, 21,
        0, 1, 1, 1, 1, 1, 0, 0, 1, 1, 1, 1, 1, 0, 20, 0, 1, 1, 1, 1, 1, 1, 1, 1, 1, 1, 1, 1, 1, 1, 1, 1, 1, 1, 1, 0,
        0, 1, 1, 1, 1, 1, 1, 1, 1, 0, 1, 1, 1, 1, 0, 1, 1, 1, 0, 0, 2, 1, 1, 0, 0, 1, 1, 1, 1, 1, 1, 1, 1, 1, 1, 0,
        20, 0, 0, 0, 0, 1, 1, 1, 0, 20, 1, 1, 1, 1, 1, 1, 1, 1, 0, 21, 3, 3, 3, 0, 0, 0, 0, 0, 0, 3, 3, 3, 3, 3, 3, 0,
        20, 21, 21, 21, 0, 0, 0, 0, 0, 21, 0, 0, 0, 0, 0, 0, 0, 0, 0, 20, 0, 0, 0, 0, 0, 0, 0, 0, 0, 0, 0, 0, 0, 0, 0, 0
    ],
    "id_nivel": "1"
}